######################
D++++++#++####+++++++#
#+##+#++++++++++###+##
#+##+#++###++++####+##
#++#+##+++#########O##
####+####++++######+##
#+++++++++##++++++++##
######+#####+######++#
################