######################
S++++++#++####+++++++#
#+##+#++++++++++###+##
#+##+#++###++++####+##
#++#+##+++#########E##
####+####++++######+##
#+++++++++##++++++++##
######+#####+######++#
################